NO ./textures/skyFading.png
SO ./textures/skyFading.png
WE ./textures/skyFading.png
EA ./textures/skyFading.png
F 51,51,51
C 211,211,211

1111111111
1000000001
1010000001
1011011101
1E00000001
1111111111
