NO ./textures/brickGrey.png
SO ./textures/brickWhite.png
WE ./textures/brickDarkGrey.png
EA ./textures/brickRed.png
F 20,25,51
C 180,180,180

11111111111111111111
10000000000001000001
10011000000001000001
10001011100000000001
10N01011111100000001
10101011000000000001
10001000000000000001
10001111111000000001
10000000000000000001
10000000000000000001
10000000000000000001
11111111111111111111
